52 21
0 11 11 11 11 11 1  10 1  1  1  1  11 11 11 11 11 11 11 11 11 11 11 11 11 11 11 11 11 11 11 11 11 11 11 11 11 11 11 11 11 11 11 11 11 11 11 11 11 11 11 0
0 11 11 11 11 11 1  1  1  1  10 1  11 1  11 11 11 11 11 11 11 11 11 11 1  1  11 1  1  1  14 1  11 11 11 11 11 11 11 11 11 11 11 11 11 11 11 11 11 11 11 0
0 11 1  1  1  11 1  1  10 1  1  1  11 11 1  1  1  1  11 1  1  1  1  11 11 11 1  13 1  1  1  1  11 1  1  1  1  1  1  1  1  1  1  1  23 23 1  1  1  1  11 0
0 11 1  13 1  11 1  1  1  1  1  1  11 1  1  1  1  1  1  1  1  1  11 1  1  11 1  1  11 11 9  11 1  1  1  1  1  1  1  1  1  1  1  1  23 23 1  1  1  1  11 0
0 11 1  1  1  1  11 11 11 11 11 11 1  1  1  11 1  1  1  1  1  1  11 11 11 11 11 11 11 11 11 11 1  1  4  5  5  5  5  5  6  1  1  1  14 23 1  1  23 23 11 0
0 11 1  1  1  1  1  1  1  1  1  1  1  1  1  1  1  1  1  1  1  1  11 11 1  1  1  1  1  1  1  1  1  1  16 17 17 17 17 17 18 1  1  1  1  1  1  1  23 23 11 0
0 11 1  1  1  1  1  1  1  1  1  1  1  1  1  1  1  1  1  11 11 11 11 1  1  1  1  1  1  1  1  1  1  1  16 17 17 17 17 17 18 1  1  1  1  1  1  1  13 1  11 0
0 11 10 10 10 10 1  1  1  1  1  1  1  1  1  1  1  12 1  1  1  1  1  1  1  1  1  1  1  1  1  1  1  1  16 17 17 17 17 17 8  5  5  5  5  6  1  1  1  1  11 0
0 11 1  1  10 12 1  1  1  1  1  12 1  1  1  1  1  1  1  1  1  1  1  4  6  1  1  4  5  5  5  5  6  1  28 29 29 29 29 19 17 17 17 17 17 18 1  1  1  1  11 0
0 11 1  1  1  1  1  1  1  1  1  1  1  1  21 22 1  1  1  1  1  1  1  28 30 1  1  16 17 17 17 17 18 1  1  1  1  1  1  16 17 20 19 17 17 8  5  5  5  6  11 0
0 11 1  1  1  1  1  1  1  1  1  1  1  1  33 34 1  1  1  1  1  14 1  1  1  1  1  16 17 17 17 17 18 1  1  1  1  1  1  16 17 8  7  17 17 17 17 17 17 18 11 0
0 11 1  1  1  1  1  1  12 1  1  1  1  1  1  1  13 1  4  5  6  1  1  1  1  1  1  16 17 17 17 17 18 1  1  21 22 1  1  16 17 17 17 17 17 17 17 17 17 18 11 0
0 11 1  1  1  1  1  1  1  1  1  1  1  1  1  1  1  1  16 17 18 1  1  1  1  1  1  16 17 20 19 17 18 1  1  33 34 1  1  16 17 17 17 17 20 19 17 17 17 18 11 0
0 11 1  1  21 22 1  1  1  1  1  1  1  1  1  1  1  1  28 29 30 1  1  1  1  1  1  16 17 8  7  17 18 1  1  1  1  1  1  28 29 19 17 17 8  7  17 17 17 18 11 0
0 11 1  1  33 34 1  1  1  23 1  23 1  1  1  1  1  1  1  1  1  1  1  1  1  4  5  7  17 17 17 17 8  5  5  6  1  1  1  1  1  16 17 17 17 17 17 17 17 18 11 0
0 11 1  1  1  1  1  1  23 23 1  23 23 1  1  1  1  1  1  1  12 1  1  1  1  16 17 17 17 17 17 17 17 17 17 18 1  1  1  1  1  16 20 19 17 17 17 17 17 18 11 0
0 11 1  14 1  1  1  1  23 1  1  1  23 1  1  1  1  1  1  1  1  1  4  6  1  28 29 29 19 17 17 17 17 17 17 18 1  1  21 22 1  16 8  7  17 17 17 17 17 18 11 0
0 11 1  1  1  1  1  23 23 13 1  1  23 23 1  1  1  1  1  1  1  1  28 30 1  1  1  1  16 17 17 17 17 17 17 18 1  1  33 34 1  16 17 17 17 17 17 17 17 18 11 0
0 11 1  1  1  1  1  23 23 1  1  1  23 23 1  1  1  1  1  1  1  1  1  1  1  1  1  1  28 29 29 29 29 29 29 30 1  1  1  1  1  28 29 29 29 29 29 29 29 30 11 0
0 11 11 11 11 11 11 11 11 11 11 11 11 11 11 11 11 11 11 11 11 11 11 11 11 11 11 11 11 11 11 11 11 11 11 11 11 11 11 11 11 11 11 11 11 11 11 11 11 11 11 0
0 11 11 11 11 11 11 11 11 11 11 11 11 11 11 11 11 11 11 11 11 11 11 11 11 11 11 11 11 11 11 11 11 11 11 11 11 11 11 11 11 11 11 11 11 11 11 11 11 11 11 0
