20 20
11 11 11 11 11 11 11 11 11 11 11 11 11 11 11 11 11 11 11 11
11 1  1  1  1  1  1  1  1  1  1  1  1  1  1  1  1  1  1  11
11 1  1  1  1  1  1  1  1  1  1  1  1  1  1  1  10 1  1  11
11 1  1  1  1  1  1  1  1  1  1  1  1  1  10 1  1  1  1  11
11 1  1  1  1  1  1  1  1  1  1  1  1  1  1  1  1  1  1  11
11 1  1  1  1  1  1  1  1  1  1  1  1  1  1  1  1  10 1  11
11 1  1  1  1  1  1  1  1  1  1  1  1  1  1  1  1  1  1  11
11 1  1  1  1  1  1  1  1  1  1  1  1  1  1  1  1  1  1  11
11 1  1  1  21 22 1  1  1  1  1  1  1  1  1  1  1  1  1  11
11 1  1  1  33 34 1  1  1  1  1  1  1  1  1  1  1  1  1  11
11 1  1  1  1  1  1  1  1  1  1  1  1  1  1  1  1  1  1  11
11 1  1  1  1  1  1  1  1  1  1  1  21 22 1  1  1  1  1  11
11 1  1  1  1  1  1  1  1  1  1  1  33 34 1  35 1  1  1  11
11 1  1  1  1  1  1  1  1  1  1  1  1  1  1  1  1  1  1  11
11 1  1  9  1  4  5  6  1  1  1  35 1  1  1  1  1  1  1  11
11 1  1  1  9  16 17 18 1  1  1  1  1  1  1  1  1  1  1  11
11 1  1  1  1  28 29 30 1  1  1  1  1  1  1  1  1  1  1  11
11 1  1  1  1  1  1  1  1  1  1  1  1  1  1  1  1  1  1  11
11 1  1  1  1  1  1  1  1  1  1  1  1  1  1  1  1  1  1  11
11 11 11 11 11 11 11 11 11 11 11 11 11 11 11 11 11 11 11 11
