10 6
11 11 11 11 11 11 11 11
11 11 11 11 11 11 11 11
11 11  1  1 12  1 11 11
11 11  1  1  1  1 11 11
11 11 11 11 11 11 11 11
11 11 11 11 11 11 11 11