20 20
6 6 6 6 6 6 6 6 6 6 6 6 6 6 6 6 6 6 6    6
6 1 1 1 1 1 1 1 1 1 1 1 1 1 1 1 1 1 1    6
6 1 1 1 95 1 1 1 94 1 1 1 1 1 1 1 1 1 1  6
6 1 94 1 1 1 1 1 1 1 1 1 1 1 1 1 1 1 1   6
6 1 1 1 1 1 1 96 1 1 1 1 1 1 1 1 1 1 1   6
6 1 1 1 1 1 1 1 1 1 1 1 1 1 1 1 1 1 1    6
6 1 1 1 95 1 1 1 94 1 1 1 1 1 95 1 1 1 1 6
6 1 94 1 1 1 1 1 1 1 1 1 1 1 1 1 1 1 1   6
6 1 1 1 1 1 1 96 1 1 1 1 1 1 1 1 1 1 1   6
6 1 1 1 1 1 1 1 1 1 1 1 1 1 1 1 1 1 1    6
6 1 1 1 95 1 1 1 94 1 1 1 1 1 1 1 1 1 1  6
6 1 94 1 1 1 1 1 1 1 1 1 1 1 1 1 1 1 1   6
6 1 1 1 1 1 1 96 1 1 1 1 1 1 1 1 1 1 1   6
6 1 1 1 1 1 1 1 1 1 1 1 1 1 1 1 1 1 1    6
6 1 1 1 95 1 1 1 94 1 1 1 1 1 1 1 1 1 1  6
6 1 94 1 1 1 1 1 1 1 1 1 1 1 1 1 1 1 1   6
6 1 1 1 1 1 1 96 1 1 1 1 1 1 1 1 1 1 1   6
6 1 1 1 1 1 1 1 1 1 1 1 1 1 1 94 1 1 1   6
6 1 1 1 1 95 1 1 1 1 1 1 1 1 1 1 1 1 1   6
6 6 6 6 6 6 6 6 6 6 6 6 6 6 6 6 6 6 6    6
