20 20
6 6 6 6 6 6 6 6 6 6 6 6 6 6 6 6 6 6 6    6
6 1 1 1 1 1 1 1 1 1 1 1 1 1 1 1 1 1 1    6
6 1 1 1 12 1 1 1 13 1 1 1 1 1 1 1 1 1 1  6
6 1 14 1 1 1 1 1 1 1 1 1 1 1 1 1 1 1 1   6
6 1 1 1 1 1 1 15 1 1 1 1 1 1 1 1 1 1 1   6
6 1 1 1 1 1 1 1 1 1 1 1 1 1 1 1 1 1 1    6
6 1 1 1 14 1 1 1 13 1 1 1 1 1 12 1 1 1 1 6
6 1 13 1 1 1 1 1 1 1 1 1 1 1 1 1 1 1 1   6
6 1 1 1 1 1 1 15 1 1 1 1 1 1 1 1 1 1 1   6
6 1 1 1 1 1 1 1 1 1 1 1 1 1 1 1 1 1 1    6
6 1 1 1 14 1 1 1 14 1 1 1 1 1 1 1 1 1 1  6
6 1 13 1 1 1 1 1 1 1 1 1 1 1 1 1 1 1 1   6
6 1 1 1 1 1 1 12 1 1 1 1 1 1 1 1 1 1 1   6
6 1 1 1 1 1 1 1 1 1 1 1 1 1 1 1 1 1 1    6
6 1 1 1 15 1 1 1 13 1 1 1 1 1 1 1 1 1 1  6
6 1 12 1 1 1 1 1 1 1 1 1 1 1 1 1 1 1 1   6
6 1 1 1 1 1 1 14 1 1 1 1 1 1 1 1 1 1 1   6
6 1 1 1 1 1 1 1 1 1 1 1 1 1 1 15 1 1 1   6
6 1 1 1 1 13 1 1 1 1 1 1 1 1 1 1 1 1 1   6
6 6 6 6 6 6 6 6 6 6 6 6 6 6 6 6 6 6 6    6
